Preston,1,247,450,203,190
Novak,10,310,455,145,190
Durham,11,317,460,143,190
Gibson,12,324,465,141,190
Weiss,13,331,470,139,190
Blanchard,14,338,475,137,190
Bauer,2,254,480,226,190
Benton,3,261,485,224,190
Hensley,4,268,490,222,190
Patel,5,275,495,220,190
Cervantes,6,282,500,218,190
Dorsey,7,289,505,216,190
Garrett,8,296,510,214,190
Blake,9,303,515,212,190
